######
#  O #
# #O ##
#  O  #
# XXX #
#  # P#
#######
