###########       ###########
#    #    #########   #     #
#  X          P          X  #
##### #################     #
#     #   #########   #     #
#O                O         #
#############################
