#######################
#O####                #
# ####  #             #
#          #########  #
# #########  #######  #
#            ##       #
######  ##            #
######  ############ ##
#                  X P#
######   ##############
#######################
