########################################
#         P                            #
#   X                              #
#                    O             #
#########################