#############################################################################
#                        #                     # #                 X       O#
#          X             #                     ###                 X  #######
#       ######           #   #####             # #       ########  #  #
#       #    #           #      O#####         ###              #     #
#   P   #    #           #########   #         # #              #     #
#########    ###     #####       #   #         ###              #     #
             #O                 X#####         #O#       #      #    O#
    ##########                                           #      #############
    #                                           X        #           #      #
    #                                          # #       ##         ### X   #
    #           ###################            ###        ##         O      #
#####    ###    #                 #            # #         ##       ###     #
#   #    #O#    #####             #            ###          ##       #      #
# X                 #             #            # #           ################
#   #               #             #            ###           #
#####################             ############################
