######################################################
#        1     1    2       11                       #
#    1  11 1  11    1   1  1111                      #
#111111111111111  11111111111111111111111111111111111#
######################################################
