#########################################################
# 1         1            1 1              1           1 #
# 1 1     1 1      1 1   1 1  1 1       1 1 12      1 1 #
#111111111111111111111111111111111111111111111111111111 #
#########################################################
